cafire	california fire
rockyfire	rocky fire
tampabay	tampa bay
africanbaze	african anbaze
nowplaying	now playing
nashvilletraffic	nashville traffic
santaclara	santa clara
bayarea	bay area
personalinjury	personal injury
otleyhour	otley hour
fantasticfour	fantastic four
stlouis	st louis
caraccidentlawyer	car accident lawyer
truckcrash	truck crash
fortworth	fort worth
trapmusic	trap music
growingupspoiled	growing up spoiled
wisdomwed	wisdom wednesday
wdyouth	western district youth division
biblestudy	bible study
watchthevideo	watch video
kca	kid choice award
votejkt48id	vote music band
rip	rest in peace
binladen	people
mlb	major league baseball
omg	oh my god
jetengine	jet engine
turbojet	turbo jet
g90	car
omg!	oh my god
yugvani	yug vani
justsaying	just saying
randomthought	random thought
worldnews	world news
fant4stic	fantastic four
whatever	what ever
gilbert23	gil bert
tantonationalforest!	tanto national forest
saltriverwildhorses	salt river wild horses
sciencefiction	science fiction
warmbodies	warm bodies
pbban	community
doublecups	double cups
truelove	true love
startrek	star trek